0 0 0 0 0 0 0 0 0 0 0 0 0 0
0 1 1 1 1 1 1 1 1 1 1 1 1 0
0 1 1 6 1 1 1 1 1 1 7 6 1 0
0 1 1 1 1 1 1 1 1 1 1 1 1 0
0 1 1 1 1 1 1 1 1 1 1 1 1 0
0 1 1 2 1 1 1 1 1 1 1 1 1 0
0 1 1 1 1 1 3 5 1 1 1 1 1 0
0 1 4 7 1 1 1 1 1 1 1 1 1 0
0 1 1 1 1 1 1 1 1 1 1 1 1 0
0 1 9 5 1 1 1 1 1 5 4 1 1 0
0 1 1 1 1 1 1 1 1 1 1 1 1 0
0 1 1 1 1 1 1 8 7 1 1 1 1 0
0 1 1 1 1 1 1 1 1 1 1 1 1 0
0 0 0 0 0 0 0 0 0 0 0 0 0 0
